0 5 0 5 0 5 0 5 0
4 0 4 0 4 0 4 0 4
0 3 0 3 0 3 0 3 0
2 0 2 0 2 0 2 0 2
1 1 1 1 0 1 1 1 1