1 1 1 1 1 1 1 1
2 2 2 2 0 2 2 0 2 2 2 2
3 0 3 3 3 3 0 3
4 4 0 4 4 0 4 4
5 5 5 0 0 5 5 5
0 0 0 0 0 0 0 0