2 3 4 5 5 4 3 2
5 2 3 4 4 3 2 5
4 5 2 3 3 2 5 4
3 4 5 2 2 5 4 3
0 1 0 1 0 1 0 1